wwwwwwwwwwwwwwwwwwwwwwwww
w p                     w
wwwwwwwwwwwwwwwwwwwwww  w                    
w                       w
w                       w
w                       w
w                       w
w                       w
w                       w
w                       w
w                       w
w                       w
w                       w
w                       w
w                       w
w                       w
w                       w
w                       w
w                     g w
w                       w
wwwwwwwwwwwwwwwwwwwwwwwww
