wwwwwwwwwwwwwwwwwwwwwwwww
w p                  e  w
wwwwwwwwwww   wwwwwwwwwww
w                  eeee w   w
wwwwwwwwwwwwwwwwwwwww   w
w                       w
w                       w
w                       w
w                       w
w                       w
w                       w
w                       w
w                       w
w                       w
w                       w
w                       w
w                       w
w                     g w                 
w                       w
wwwwwwwwwwwwwwwwwwwwwwwww
wwwwwwwwwwwwwwwwwwwwwwwww
